15 15 30
00000000000000000
01111111111111110
01000100010000010
01010101010111010
01010101000101010
01010101111101010
01010000000001010
01011111011111010
01010001200001010
01010101011111010
01000111000101010
01111101111101010
01010001001000010
01010111101011110
01000000000000310
01111111111111110
00000000000000000
