23 23 50
0000000000000000000000000
0111111111111111111111110
0100000100000100000000010
0101010111010111011101010
0101010100010000010101010
0101010101111111110101010
0101010001010000000001010
0101011111010111111111010
0101010000010100000000010
0101011101110111011111010
0101000100010001010101010
0111110101011111110101010
0100000101002000000101010
0101111101011111111101010
0101000101010000000101010
0101011101110111110101010
0101000000000101000100010
0101011101011101011101110
0101010001000001010101010
0101010101111111010101010
0100010100000100010100010
0101110111110101110111010
0100010000010001000000310
0111111111111111111111110
0000000000000000000000000
