11 11 20
0000000000000
0111111111110
0100000000010
0101111111010
0100000100010
0101110111010
0101012001010
0100010101010
0101010101010
0111010111010
0100010001310
0111111111110
0000000000000
