19 19 40
000000000000000000000
011111111111111111110
010000010000010000010
010111010111011101010
010100010001000101010
010101111101110101010
010100000001000101010
010101111111110111010
010101000000010000010
010111011111011111010
010100010120010100010
010101110101110101110
010001000101000101010
011101011101010101010
010100010001010001010
010111110111011111010
010100010001010000010
010101011101011111010
010001000001000000310
011111111111111111110
000000000000000000000
