27 27 60
00000000000000000000000000000
01111111111111111111111111110
01000000010000000000010000010
01011111010101111111110111110
01000101010100000100000100010
01110101010111110101111111010
01010001000100000101000000010
01011101111101011101011111010
01000101010001010001000001010
01110101010111110111111101010
01000101010100000100000101010
01011101010101111101110101010
01000000010101000001000101010
01011111110101110101011101010
01000100000100210101000001010
01111101110111010101111111010
01000001000001010100010001010
01011101111111011111011101010
01010001000000010000010001010
01011111011111110111110111010
01000100010000010000010100010
01010101110111011111010101110
01010101000101010000010100010
01010101011101010111110111010
01010100010001000101000001010
01010111110111111101010111010
01010000000000000000010000310
01111111111111111111111111110
00000000000000000000000000000
